Vowels
a - бАнк
i - крИк
u - Утюг
e - Это
o - Очень 
y - Уже

Unstressed Vowels
A - мОлоко
E - лЕжит , глЯжу
Y - бЫла , солнцЕ

Consonants
p - Поле
b - Был 
ch - Чай
c - Цапля
t - Тоже
d - Даже 
k - Кто
g - Где
f - Фото 
v - Вас 
s - Свет
z - Зонт
h - Холм
sh - Школа 
zh - Жизнь 
m - Море
n - Нора
l - Лучше 
r - Рот
j - Йогурт 

Soft Consonats
pj - Пень
bj - Белка
tj - Тень
dj - День
kj - Кем 
gj - Германия 
fj - Ферма
vj - Веер
sj - Сегодня 
zj - Земля 
hj - Хит
shj - Щит
mj - Меня
nj - Небо
lj - Лето
rj - Река
